Family	Genus
Rhodanobacteraceae	Dokdonella
Zoogloeaceae	Zoogloea
Moraxellaceae	
Nitrospiraceae	Nitrospira
Chitinophagaceae	
Kofleriaceae	Haliangium
Comamonadaceae	Rhodoferax
Comamonadaceae	
Rhodocyclaceae	
Azonexaceae	Dechloromonas
Campylobacteraceae	Arcobacter
Flavobacteriaceae	Cloacibacterium
Rhodocyclaceae	
Saprospiraceae	
Canthomonadaceae	
Leptospiraceae	Turneriella
Sphingomonadaceae	Zymomonas
	Sulfuritalea
Moraxellaceae	Acinetobacter
	Candidatus Accumulibacter